.................
.................
.................
.................
.................
.................
.................
.................
..O1.............
..112............
...2234..........
....33xxx........
....4............
.................
.................